11111111111111111111
10001110111000111101
10110000001101100001
10110111101101101101
10000110101100001101
10110000100001111101
11010111001111000011
10000001010000011001
11111101010111111011
10111101100100000001
10000001001111111101
10111101101000100111
11000100000010110001
11010101011110001101
10010001010000100001
11111111111111111111