11111111111111111111
10000100000000100001
10101011110111010101
10111000010100011101
10000111010101100001
11110101000001101011
11100001110110000111
10011100000000111001
11010101110110101011
10000001110010000001
11110110110101101111
10000100010100100001
10110101010110101101
10101001110110010101
10000100000000100001
11111111111111111111