11111111111111111111
11010000110100000101
11010110110101110101
10000110000101000001
10111110111001011111
10101110010011000011
10000010110101110101
11110110000100000101
11000110111101111101
11110110110000000001
10000110001011111111
11101111111010001011
10101111101110101011
10001000100010101011
11100010001000100011
11111111111111111111