11111111111111111111
10100010000000100101
10001011111011010001
11101100000001000111
10001011101010110001
11100000101000111101
10001011101110100001
11101000000000101111
10001011101110100001
10111010101000001111
10001010101110100001
10110100000001101111
10010110111111100001
11010000000100011101
10010101010001000101
11111111111111111111