11111111111111111111
10000000001010100001
11101101101010101111
11101101101010001001
10001011100010101011
10111000011010110001
10111011111010000101
10001000010000110101
11101111011010101001
11101000011010001011
10001011010111101111
10101001010000100001
10101101001101010101
10111101100100000011
10000000010110101001
11111111111111111111